1111111111111111111111111
1111111111111111111111111
1P000000010C00011111000C1
11101C0101111000111001001
1E00000100C00010000001C01
1111111111111111111111111
