11111
11111
1P001
110C1
1E001
10001
10001
11111
