11111
1P001
1C001
1E001
11111
