111111111111111111111111111111111111111111
111111111111111111111111111111111111111111
100000000000C00000000000000000000000000001
100000C000000000CC0000CCC00CC000CC00000001
1C000000000P000C00C00C00000C0C0C00C0000001
100000000000000CCCC00C0CC00C0C0CCCC0000001
100000000000000C00C000CCC00CC00C00C0000001
100000E00000C00111111111100000000000000001
100000000000000111111111100000000000000C01
111111111111111111111111111111111111111111